HHHHHHHHHHHHHHHHHHHHHHHHHHHHHHHHHHHHHHHHHHHHHHHHHHHHHHHHHHHHHHHHHHHHHHHHHHHHHHHHHHHHHHHHHHHHHHHHHHHH
HOHHOOHOHOOOOOOHOHOHOHHOOOHOHOOHOHOHOOOOOOHHOHOHHOOOOHHOOHHOOOHOOHOOOOOHOHOHHOHOHHOOHHOOOOOHHOOHOHSH
HOOHHOOOHHHHHHOOOOOHOOHOHOHOHHOOOOOHHHOHHOHOOOOHHHOHOOHHOOHHHOHOHHOHHHHHOHOHOOHOOHHOHHHOHHHHHHOHOOOH
HHOHHHHOHOOOHHHOHHOOOHHHHOHOOHHHHHOOOHOHOOOOHHHHOHHHHOHOOHHOHOHOHHOHHOHHOHOHOHHOHHOOHOOOOHHHOHOHOHHH
HOOOOOHOOOHOOOHHHOOHOOHHOOHOHHOHOHHOHHHHHHHOOHHOOOHOOOHHOHOOOOOOOOOOOOHHOHOHOOOOOHHOOOHOHHOHOHOHOHHH
HHHHHOHHHOHHHOHHHHHHHOHHHOOOOOOOOHOOOHHOHOHOHHHHHOHHHOHOOHHHOHOHHHOHHOOHOHOHOHHHHHOOHHHHHHOHOOOHOHOH
HHHHOOHHHHHOHOHOHHHOHOHOHHHOHHHHOHHOHHOOOOOOOHOHOOHHOOHHOOHHHHOOHHHHHHHHOHOHOOOHHOOHHHHHOHOOOHOHOOOH
HOOHHOOOHHOOHOHOHOHOHOHOHOHHHOHOOOOOOHHHHHHOHHOOOHHOOHHHHOOHHOOHHOHOHHOHOHOOOHHHHHOHHOHOOHHOHHHHHHOH
HHOHHOHOOHHOHOHOHOHOHOHOHOHHOOHHHOHHHHOOOOOOOHOHHHHHOHOHOOHHHHOOHOOOOHOOOOOHHHOHOHOOOOHOHHOOHOHHOHOH
HOOHHHHHOHOOOOOOOOOOOOOOOOOOOHHOOOOHOHHHHHHHOHOHOHOOOOOOOHHHOHHOHOHHHHOHHHHHOHOHOHHOHHHOHOOHHOOHOOOH
HHOHOHOHOOOHOHOHOHHOHHOHHHOHHHHHHHOOOHOHOOOHOHOHOHHHHHHOHHOHOOHOHOHOOHOHHOOHOHOHOHOOOOHOHOHHHHOHOHHH
HOOOOOOOOHOHOHHHOHHHHHHHOOOOHHOHHHHHOOOHOHOOOOOOOOHHOOOOHOOHHOHOHOHOHHOHOOHHOHOHOHOHHHHOHOHOHOOOOOOH
HHHHHHOHOHOHOHHHOHOHHOHHHHHOHHOOOOOOOHHHHHHOHHHOHHHHHHOHHOHHHOOOOOOOOOOOOHHHOOOOOHOOOOOOOOOOOOHHOHHH
HHHOOHHHHHHHHHOOOHOOOOHOHOOOOHHHHHHHOOHOOHHHHOOOHOHHOHOHHOHOHHOHHHHHHHHHHHOHHHHHOHOHHHHHHOHOHOHHOOOH
HOHHOOOHHOHHOOOHHHHHHOOOOOHHOOOOHHHOOHHOHHOHHHHOOOHOOOOHHOHOOHOOOOOOOHOHHOOOHHOOOOOOOHHOHHHOHOHHHHOH
HOHHHOHHOOHHHHHHHHOHHHHHHOHHHOHHHOHHOHHOOOOOOOOOHOOOHOHHOOHHOOOHOHOHOOOOHHOHHHHHOHHHHHOOOOHHHHHOHHHH
HOOHHOHOOHHOHOHHOOOOHHHHOOHOOOOHHOOOOOHHHHHOHOHOHHHHHOOHHOHHOHHHHHHHHOHHHOOOHHOHOOOOOOOHHOOHOHHOHOHH
HHOHHOHHOHOOOOOHHHHOOOOOOHHHHOHHHHHHHOOOOOHHHHHHHHOHOOHHOOHOOOOOOHHOHHHOHHOHHOOHOHHHHOHHHHHHOHOOOOOH
HHOHOOOHOHHOHHOOHOHHHHHHHHOHHOOOHOHOHHOHHOOHOHOHOOOHHOOHHOHHOHHHHHHOHHHOHHOHOOHHOHHHHHHHOHHHOHOHHHOH
HOOOOHOHOHHOHHHOOOOOOOOOOOOOOOHOHOOOOHOHOOHHOOOHOHOHHHOHOOOOOOHOHHOOHOHOHHOOOHHOOHOOOHOHOOOOOOOOOHHH
HOHHHHOHOOHOHOOOHHHHOHOHOHOHHOHOHHHHOHHHHOHHHHOHHHOHOHOHHHOHHOOOHHOHHOOOOOOHOOHHOOOHOOOOOHHHHHOHOHHH
HOHOOOOHOHHHHHHHHHHHOHHHOHHHHHHOHHHOOOHOHOOHHOOHHHOHOOOOHHOHHHHHHOOOOOHHHHHHHOHOOHHHHHHHHHOHHHHHOOOH
HHHHHHOHOHOHHOHHOOOOOOHHHHOOOOOOOOHHHOHOHOHHOOHHOOOOOHHHHHOHOHHOHHOHHOOOOHHOHHHHOHHOHOOHHOOOOOOHHHHH
HOOOOOOOOOOHHOOHHHHHHHHOOHHHHHHHOHHOHOHOOOHOOHHHHHHHOHOHHOOOOOOOOOOOHHHHHHHOOHOHOOHOHHOOOOHHOHHHHOHH
HHHOHHOHOHOOHHOHHOHHHOOOHHHOHOHOOOOOHOHHHOHHOOHHOHHOOOOHHOHHHHHHHHHHHHOOOOOOHHOHOHHOHHOHHOOHHHHOOOOH
HOHHHHHHHHOHHOOOHOHOHHHOOHOOOOHHHHHOOOHHHOHHOHHOOOOOHHOOOOOOHOHHHOOOOOOHHHHHHHOOOOOOOOOOHHOOOOHHOHOH
HOHHOOHOHOOHHHHOHOHOHOHHOHHHHOOOOOOOHOHOHOHOOOHHHHHHHHHHHHOHHOHOHHOHHHHHOHOOOOOHOHHOHHHHHHHHHHHOOHHH
HOOHHOOOHHOHOHOOOOOOOOHOOOOOOOHOHHOHHOOOOOOOHOOOHHOHOHOOOOOOHOOOHOOOHHOOOOOHOHHHOOHOOHHHHOHOHHOOHHHH
HOHHHHHOHHOOOHHHHOHHHOOOHOHOHOHOHHOOHHHHHHHOHHOHHHOHOHHHHHHOHOHHHOHOOHHHOHHHHHHHHHHHOOOOHOHOOHHOHHOH
HOHHOHHOOHHHOOOHHHHOHOHOHHHHHHHHHHHHHHOOOHHHHHOOOHOHOHHOOHHOOOOHHOHHOOOOOOOOHOOOOHHOOHHOOOOOHHOOOOOH
HOHHOHHOHHHHOHOOOHHOHHHHHOOOOOOOOOHOOOOHOOOHHOOHOOOHOOHHOOHOHHHHOOOHOHOHHHHOHOHHHHHHHHHOHOHHHHOHHHHH
HOOOOHOOOHOHHHHHOHHOOHOHHHHHHHHHHOHHHHOHHHOHHHHHHHOHHOOHHOOOHOOOOHHHHHOOOOHOHOOOHHOOOOHOHOOOOOOOOOOH
HHHHOOOHOOOOOOOOOOOOHHOOHOOOOOOOOOOOHOOHOOOHOHHOHOOOOOHHHHHOOOHHHHHOHHHHOHHOOOHOOHOHHHHHHHHHOHHOHHOH
HOHHHOHHOHHHOHOHHOHOOHHOHHHHHHHHHHHOHHOHHHOOOOOOOOHHHOOHHOOOHOOOOOOOOOOHHHHHOHHHOOOHOOHHOOOHOHOOOHHH
HOOOOOHOOHHOOHOOHHHOHHHOOHOOOHOHOHHOHHHHOOOHOHOHHHHOHOHHHHHOHHHHOHOHHOHHHOHHOOHHOHOOOHHHOHHHHHHHOOOH
HHOHOHHHOOHHHHOHHOOOHOHHOHHHOOOOOHOOOHHOOHOHHHHHHHOOOOOHOHOOOHOHHHHHHOOOOOOHOHHOOHHHOOOOOOHOHOHHOHHH
HOOHHHOOOHHOOOOHHHHOOOOOOHHOOHHHOHHOHHOOHHOHOOHOOOOHHHOHOHOHOOOOHOHOHHOHHOHHOOHHOOHHHOHHHOOOOOOHOOOH
HHOHOOOHHHHOHOHHOHHHHHHOHHHHHHOOOOOOOOOHHOOHHOOOHHOOHHOOOOOHHOHOOOOOHHHHHHHOOHHHHOOOHHHOOOHHHHHHHHOH
HHHHHHHHHOHHHHHHOHOHHOHOHOHHHHHHHHOHOHOOHOHHHHHOHHHOOHHHOHOOHHHHHHHHHOHHOOHOHHHOHHOHHHHOHOOOOOOOHHHH
HOOHHOHOHOHHOHOHOHOOOOOOOOHOOHHOOOOHOHOHHHHHOHHHHOOOHHOOOHHOOOOOHOOOHOOOOHHOOOOOOHOOOOHOHHOHOHHHHOHH
HOHHOOOOHOHOOOOOOOOHOHOHHOOOHHHHOHOHHHHHOHOHOOOHOOHOHHHHOOHOHOHOOOHOOOHHHHHHHHOHOHOHOHHOOHHHOOOOOOOH
HOOHHHHOHOHHHHOHHHOHHHHHHHHOHOOHHHHHHOHHOHOHHHOOOHHOHOOOOHHOHHHOHHHHHOOOOHOHHHHHHHHHHHHHOOHHOHHOHOHH
HOHHOHHOOOOOOOOHHHHHHHHHHHHOHHOHHOHOHOHHOHOHOHHOHHHHHHHOHHHOOOHHHHOHOOHHHHOOOHHOOOOOOHOHHHHOOOHHHOOH
HOOOOOOOHOHOHHHHOOHHOHOHHOOOOOOOOOOOOOOOOOOOOOOOOHOHOHOOHHOOHOOOOOOHHOOOOHHOHHOOHHOHHHOHHOHHHOOOHHHH
HHOHHOHHHHHHHHHHHOOOOOOHOOHHHHHHOHOHHHOHHOHHOHOHOHOOOOOHHOOHHHHOHHHHOOHOHHHOOOOHHHHHHHOOOOOOHOHOOOOH
HOOHHOHHOOOOOOOOHHHHHHOOOHHOOOOOOHHHOOOHOOOHOHHHHHHOHHOOHHOOOHHOOOOHHOHHHOHOHHOOOOHHOHOHHHHHHHHHHHOH
HHHHOOHHHHHHHHHOOHOHOHOHOOHHHHHHOHHOOHOHHOHHHHHOHOOOHHOHHHOHHHOOHOHHHOOOOOOOOHHHHHHHOHOOOOOOOOOHHHHH
HOOHHHHOHOOOOOHHOOOOOOOHHHHHOHOOOOHHOHOHOOHHOOOOOOHOHHOHHOOOOHHHHOOOHHOHOHOHOOHHHHOHOOOHOHHOHOHHOHHH
HOHHOHOOHHHHHOOOOHHOHOHHHHOHOHHOHOHHOHOHHOHHHOHHOHHOHHOHHHOHHHHHOOHHHHHHOHHHHHHOOOOOOHOHHHOOHOOOOOOH
HOHHOHHOOOOOOOHOHHOOHHHOOOOOOOOOHHHHHHHHHHHOHOHOOOHOHHOHOOOOHHOHHOOOOOHHOOOOOOOOHOHHHHOOOHHHHOHHOHHH
HOOOOOHHHHOHOHHOOHHOOHHHHOHOHHOHHHOHHOHOHOOOOOHHOHHHHOOHHOHOOOOHHOHHOHHOOHHOHHHHHHHHHHHHHHOHHHHHOOHH
HOHHHOOOOOOHHHHHOHHOHHOOOOHHHOOHHOOOOOOOOOHOHOHHOOOOHHHHOOHOHHHHHOHHHHHOHHOOOOOOOOOOOOOHOHOOOOOHHOOH
HHHHHHHHOHOHHHOOOHHOOHHOHOHOOOHHHHHOHOHOHOHHHOHHHOHOOOOHHOHOOOOOHOOOOOHOOHHOHOHHHOHHOHHHOOOHHHOOHOHH
HOOOOOOOOHHHOOOHOHHOHHHHHHHHOHHOOOOOHOHHHOHHOOOOHOHOHHOHHHHOHOHHHOHHOHHOHHHOHOOOHOHHOOOOOHOOOHOHHOOH
HHHOHOHOHHOOOHOHOHOOHHOOOOOOOHHOHOHHHOOHHOHHHOHOHOHOHHOOHHOOHOOHHOHOOOHOOOHOHHOHHOHHHHOHHHHHHHHHOOHH
HHHHHOHHHOOHOHOHOHHOOHOHHOHOHHOOHOHOOOHHHOHOOOHOHOHOOHHOHOOHHHOOHHHHOHHHOHHOHHOOHOOOHHHHOOHHHOHHHOOH
HOOOOOOOHHHHHHOHOOHHOHHHHOHOHHHHHHHHOHHOOOHHOHHOHHHOHHHHHOHHOHHOHHHOOOOHOOHOOHHOHOHOOOOHHOOOOOOOHHOH
HOHHHOHOHHOOOOOHOHHOOHOOOOHHHOOOOHHOOHHOHOOHHHHOHHOOHOHOOOOOOHHOOOHHOHHHHHHHHHOOHOHHOHOOOOHOHHHHHHHH
HHHOOOHOHOOHOHOHOOHHOHHHOHHHHHHHOOOOHHHOHOHHOOOOOHHOOOHOHOHHHHOOHOHOOOOOOOOOHHHHHOHHOHHHOHHHHOOHHOHH
HHHOHOHOHHOHOHOHOHHHHHHHHHHOHOHHHOHHHOOOHOHHHOHOHHOOHHHHHOOOOHHOHHHOHOHHHHHHHOHHOOHHOOHHOOOHOOHHHOOH
HOOOHOHHHOOHOHHHHHHOHHOHHOOOOOOOOOOOHHHHHOHOHOHOHHHOOOHHOOHOHHOOHHOOHOOHOOOOHOOHHOHHOHHHHOHHOHHOHOHH
HHOHHOOOHHOHOHHOHHOOOOOOOOHOHHOHOHOHHOOOOOHOOOHOHOOOHOHHOHHOOHHOHHOHHHOOOHHHHOHHHHHHOOHHOOOOOOOOOOOH
HHHHHOHOOHHHOHOOOOOHOHHHOHHOHOOHOHOOHHHHOHHHOHHOHOHOHOOHOHOOHHOOOHOHHOOHOOOHHOOOHHHOOHHHHOHHHOHHOHOH
HOOOOOHOHHHOOHHOHHOHOHHOOHHHHHOHOHOHHOOOOHOOOHOOHOHOHOHHOHHOOHHOHHOHHOHHOHOOOOHOOOHHOHHOHOOOHOOHHHOH
HHHHOHHHHOHHOOHHHHHHHHHHOHOOOOOHOHOOHHOHOHOHHHOHHHHOHOHHOOHHOHOOHHOHHOHHOHHOHOHHHOHHOOHOHOHOHHOOHHOH
HHHHOHOHOOOOOHHOOHHOOOOOOHOHOHOHOHOHHOOHOHOHOOOOOOHOHOHHHOOHHHHOHHOHHOHHOOHHHOOOHOOHHOOOHOHHHHHOHHHH
HOOOOHOOOHHOHHHHOHOOHOHHOHOHOHHHOHHHHHOHOHOHOHOHHOHOHOHOHOHHOOOOOHOHHOOHHOOOHHOHHOHHHHOHHOOOHHOOOOOH
HHHHOHOHOHOOHOOHOHHOHHHHOHOHOHOOOOHHOOOHOHOHOHOHHOHOHHHOOOOHHHOHHHOHHOHHHHOHHHHHHHHOHOOOHHHHHHHOHHOH
HOOOOHHHHHOHHHOOOOOOHOOOOHHHOHHOHOOHOHOHOHOHOHOHHOHOOOHHHOHHOOOHHOOHHOHHHHOOOOOOHHHOHOHOOOOOOHHOHHOH
HOHHOHHOHOOHHHHHHHHHHHOHOOOHHHHOHHOHOHOHOHHHOHHHHOHOHOHHOOHHOHOOHHOHHOOHHOOHOHHHHOHOHHHHOHHHHHOOHHOH
HOHHOHOOHHOOHHOOOOOOOOOHHHOHHOOOOHOHHHOHOOHHHHHHOOHOHOOHHOHOOHHOHHHHOOHHHOHHOOOOOOOOOOOHOOOOHHHHHHOH
HHHHHHHOOOOHHOOHOHHHOHOHHOOHHHOHOHOHHOOHHOOHHOOOOHHHHHHHHHHHOOHHHOOOOHHOHHHOOHHOHOHOHOHHOHHHHOHHOHHH
HOOHHOHHOHOOHHOHHHHOOHOOHHOHOOOHOHHHHHOHOOHHHHOHOOHHOHOOOHOOOHHOOOHHOOHOHHHOHHHOHHHHHOHHOOOOOOOOOHHH
HHOHOOOOOHHOOHOHOOOOHHOHHOOHHHOHOOOHOHHHHOHOHOOHHOOOOHHHOHHHOHHHHHHHHOOOOOHOHHOOOOOOHOHHOHOHHOHHOOOH
HOOOOHHHOHHOHHHHHOHOHHOHHHOHHOOHOHOOOHHOHOOOHHOHHHHOHHHOOOOOOOOOOHHOOOHOHOHOOHHOHOHHHOOHHHOHHOOHOHOH
HHOHOOHHOHHHHOHOHHHHHHOHOOOHHHOHHHOHOHOOHOHHHHOOOHHOOOHHHHOHOHOHOHHOHOHHHOHOHHOOHOOOHOHHHHOOHHOHHHOH
HHHHOHHHHHOHOOOOOOOOOOOHOHOOHHOOOHOHHHHOOOOOOHOHOHHOHOOHHHOHHHOHOHHOHOOHHOHOOHHOHOHOHOOHOHOHHOOOOHOH
HOOOOHHOOOOOOHHHHHHHOHHHHHHOOHHOHHHHHOHHHOHHHHOHOOHHHHHHOHOHOOOHOOHOHHHHHOHOHHHOHOHHHHOHOHHHOOHOHHHH
HHHHOOHHOHOHOHHOOOOOOOOOOOHHOHHOHOHHOOOOOOOOOHOHHOHHOOOOOOOHOHOHOHHOOOOOHOHOHOHOHOOHHOOOOOOHHOHHHOHH
HOOOOHHHOHOHOOHHHHHHOHOHHHHHHHHHHOOOOHOHHOHOHHOOHHHHHHOHHOHHOHOHOOHOHHHOHOHOOOHOHHOOHHOHHOHHOOOOOOOH
HOHHOHHOOHHHHOHOOOOOOHOOOOHOHOHHHOHOHHOHOOHOHHOHHOOOOOOHHOHHOHOHHOHOHHHHHOHHOHHOHHOHHHHHHHHHHOHHHHHH
HHHOOHHHOOOHHHHHHHHHOHHOHHHOOOHOOOHOHHOHHOHOHOOOHHHHHHOOHHHOOHOHHOHOOOOOHOHHOOHOHHOOOOOOOHHOOOOOHOHH
HHHHHHOOOHHHOOOOOOOOOHHOOOHHHOHOHOHOHHOHHOHHHOHOOHHOOOOHHOOOHHOOHOHOHOHOHOOHHOHOHOOHHOHHHHHHOHHOOOOH
HOHHHHHHOHOHOHHHOHHHOHHHOHHOOOOOHOHOHHOHOOHOOOHOHHHHOHOOHHOHHHHOHHHOHOHHHOHHHHHHHHOOHOHHOOOHOOHHOHHH
HOOOOOOOOHOOOHOOOHHOOOHHOOHHHHHOHHHOHHOHHOHHHOHOHHOOOHHOHHOOHHOOOOHOHOOOHOHHOOOOOOOHHOOOOHOHHHHHOOOH
HOHOHHOHOHOHOHOHOHOOHOOHHOHOHHHOOOHOHOOOHOHOOOHOOHOHOOHOHHHOHHOHOHHHHOHHHOOHHHOHHHOOHOHHOHOOOHOHHOHH
HOHOHHOHOHOHHHOHOHHOHOHHHHHOOOOOHHHHHOHOHOHOHOHOHHHHHHHOOHHOHHOHOOHHOOOOHOHHOOOHHOOHHOOHHHOHOOOHHHHH
HHHOHHOHOHOHHOOHOHHOHOHOOHHHHHHOOOOHHOHHHHHOHOHOOOOOOOHHOOHHHHOHHOHHOHHOHOOHHHOOHHOHHOHHHHOHOHOOOOOH
HOOOOHOHHHHHHHOHOHHOHHHHOOOOOOOOHHOOHOOOOHHOHOHOHHOHHOHHOHHHOOOHHOOHOHOOHOHHOOOHHOOHHOOOOHHHOHOHOHOH
HOHOHHOHOOOOOOOHOHHHHHOOOHHOHOHOHHOHHOHOHHHHHHHOOHOHHOOHOHOOOHOOHOHHHHHHHOHOOHOHHHOHHOHHOOOHOHOHHHOH
HOHOOHOHHHOHHOHHOOHHOOOHHHHOHOHOHHOHHOHOHOHHOOOOHHOOHOHHHHHHOHHOHOOOHHOOOOHOHHHHOOOOHOOHHOHHHHOOOHOH
HOHOHHHHOOOHOOHOOHHHHOHHOOOOHOHOHOOOHHHOOOOHHHOHHHHOHOHOHOOOOHHOHOHHHHHHHOHHHOHHHHOHHHOOHOOOOHHOHHHH
HOHHHHHHHHOHHOHHOOHHOOOHHHHOHOHHHOHOHHOOHHHHHOOOOOHOHOOOHHHHOOHHHOOOOHHHOOOHHOOOOOOOHHHHHHOHOHOOOOHH
HOHHOHOOOOOOHHHHHOOHHOHHOOOOHOOOHHHOOHHOOOHHOOHOHHHHHHOHHHOOOHHHHHOHHHOOOHHHHHHOHOHOOOOOOHHHHHOHHOOH
HOOOOHHOHHOHHOOOHHOHOOOHHOHOHHHHHOOOHHHOHHHHHOHOOOOOOHHHOHHOHHHOOHOHOHHHOHOHOHOOHHHHOHHHOOOOOHOHHHHH
HHOHOHOOHOOOHOHOOHOHHOHHHOHOOOOOHHHOHHOOOHHOOOHOHHHHOOHHOOHOOOHHOOOOOOHHOHOOOOOHHOOOOOOHHHHHHHHHOOOH
HOOHOHOHHHOHHHHHOOOHHOHHOOHHOHHOHHOOOHHOHHOOHOHOOHHHHOOHHOOOHOHOOHHHOHHHOHOHOHOOHHHOHOHHHHOHOHHOOHHH
HHOHOHHHHOOHOHOHOHOHOOOHHOHHOOHOOHHOHHOOOHHOHHHHOOOHHHOHOOHOHOHHOHHOOOOHHHOHHHHHHOOOHOOOOOOOOOOOHHOH
HGOHOOHHOOHHOOOOOHOHOHOHHOOHHOHOHHOOHOOHOHHOHOOOOHOOOHOHHOHOHOHHOOHHOHOHOOOOOHHOOOHOHOHOHOHOHOHOOOOH
HHHHHHHHHHHHHHHHHHHHHHHHHHHHHHHHHHHHHHHHHHHHHHHHHHHHHHHHHHHHHHHHHHHHHHHHHHHHHHHHHHHHHHHHHHHHHHHHHHHH
