HHHHHHHHHHHHHHHHHHHHHHHHHHHHHHHHHHHHHHHHHHHHHHHHHHHHHHHHHHHHHHHHHHHHHHHHHHHHHHHHHHHHHHHHHHHHHHHHHHHH
HOOHOOOHHOHHOOOHOHOHOHOOOOHHOHHOOOHHOOOOHOHOHHOHOOOHHOOHOHOOHHOOOHHOHHOHOOOOOOOOOHOOOOOOHOHOHHOHHOSH
HHOHHOHHOOOHHOHHOHOHOHHOHHHOOOHOHHHHHHHOHOOOHHOHOHOOHHOOOHOHHHHHOOHOHOOHHHHHHHHHOHOHHHHHHOOOOHOHOOHH
HOOHOOHOOHHHOOHHOHOHOHOOHOHHHOHOOHHOHHOOHOHOHHOHHHOHHHHHOHOHHOHHHOOOOOHHOOHOHHHOOOOOHOHHOOHHOHOHHOOH
HHOHHOHHOHOHHOOHOHOHOHHOOOHHOOHOHHOOOHHOHHHOOOOOHOOOHHOOOOOHHOOHHHHOHHHHHOHOOOHHHOHOOOOHOHHHHHOHHOHH
HOOHHOHOOOOOHHOOOOOOOHHOHHHHHOHOOHHOHHOOOHHHHHHOHHOHHHHHHHOHHOHHOOOOOHOHHOHOHHHHHOHHHHHHOOHOHOOHHOHH
HHOHHOHHHHHOHHHHHOHHOOOOOHHOOOOOHHHOOHHOHHOHHOHOHOOOHHOOOHOOHOOHHHHOHHOHOOHOOHHOHOHHOHOOOHHOHHOOOOOH
HOOHHOHHOHOOOHHOHHHHHHHHOOHHOHHOOHOOHHOOHOOOOOOOOOHHHHHHOHHOHOHHOHOOHHOHOHHOHHOOOOHOOOOHHHOOHHOHOHOH
HHOHOOHOOHOHHHOOHHOOHHOHOHHHHHOOHHOHHHHOHHHHHHHHHOHHOHHOOOOOHOHHOOOHHOOHOHHOHHOHHHHOHHHHOHHOOOOHHHHH
HOOHHOHHOHOOOHHOOHOHHOOHOHHOHOOHHOOHOHOOOHHHHOHHOOOOOOHHHHHOHOOHHHOHHOHHOHHOHHOHOHOOOOOHOOOOHOHHHOHH
HHOOHOHHOOOHHHHHOHOHHHOOOOOOHHOHHOHHOHHOHHOOOOOHHHOHHHHHOHHOHOHHOHOHHOOHOHOOOOOOOOOHHHOOOHHHHOHOOOOH
HHHOOOOHHHOHOHHOOHOOHOOHHHHOHOOOHOHHOHHOOHHHOHOOOOOOHOHOOHHOHOHHOHOHHHOOOHHHOHHHOHOOOHHHHHHHHHHOHHOH
HHHHHOHHHOOOOOHHOHHOOOHHOOHHHHHOHOHHOOHHOHHHHHHHHHHOOOHHOHOOOOHHOOOOOHHOHHOHOOOHHHHHHHHOOHOOHHOOOHHH
HHOHHOHOHHHOHHHHOOHHHOOHHOOHHOHOOOHHHOHOOHOHHOHHOOOOHOOOOHHHOHHHHOHHOOHOHHOHHOHHHOOHHOHHOHOHHHHHOOHH
HOOOHOHOHOHOHOOHHOHOHHOHOOHHOOOOHHHOHOHHOHOHOOOHHOHOHHHHOHHOOOHOHHHHHOOOHHOOHOHOOOHHHOHHOOOOOOHHHOOH
HHHOOOOOHOHOOOHHOOOOHOOHHOOHHHOHHOHOHOHHOOOOOHHHHOHHHOOOOHOOHHHOHHHOHHHOOHHOOOOOHHHOHOHHOHHOHHHOHHOH
HOOOHOHOOOHOHOOHHHHOOOHHHHOOHHOHHOHOOOOHHHOHOOHOHHHHHHHHOHHOHHHOOOHOHHHHOOHHOHHHHOHOHOHOOHHHHOOOHOOH
HHHOHHHHHOOOHHHHOOHHHOOHOHOHHOOHOOOOHHHHOHHHHOHOOHHOHOOHOHOOHOHOHHHOHOHOOHHOOHOOOOOOOOOOHHOHHHHOHHOH
HOOOHHOHHHHOOHOHHOOHOOHHOHOOHHOHHOHOHOHHOOHOHOOOHHOOHHOOOHHOOOOOHHOOHOHHOOHHOHOHHOHHHHHHHOOOHHOOHHOH
HHHHHOOOOHHHOOOHHHOHHOOHOHOHHOOHHHHOHOHHOHHOOOHOHHOHHHHHOOOOHHHOHHHOHOOHHOHHOOOOHHHHHHOOHHHOHHHOHHOH
HOHHOOHHOOOOOHHHOHOOHHOOOOOOHHOOHHOOHOOHOOHHHOHHHOOOHOHHHOHOHHHOHOOOHHOHHOHHOHHHHOOOOHOHHOHOOHHOHOOH
HOHHHHHHHHOHOHHOOHOHHHHOHHHOHHHOOHHOHOHHOHHOHOOHOOHHHOOHHHHHHOHOHHHOOHOOHOHOOHOHHHOHHHOOOOOOHHHOOOHH
HOOHHOOOOHHHOOHHOHOHHOHHHHOOOHHOHHOOOOOOOHHOHHOHHOHOHHOOOHOHOOOOHHHHOHHOHOHHOHOOHOOOHHOHHHHOHOOOHHHH
HHOHHHHHOHHOOHHOOOOHHOHHOHHHOOHOOHHOHHHHHHOOHHOHOOOOHHHHOOOHHHOHHOOHOHHOHOHHOHHOOOHOHHOOHOHHHHOHHHOH
HOOHOOOOOOHHOHHOHHHHOOHOOOHHHOHOHHHOHOOHOHOHHOOHHHOHHOOHHHOHOOOOHHOHOHHOOOHHOHHOHHHHHHHOOOOHOHOOOHOH
HHOHOHOHHOOOOOHOHOOHHOHOHHHOOOOOHHOOOOHHOHOOHHOHOHOOHHOOHHOHHHOHHOOHOOHHOHHOOOHOHOHHOHOOHHHHOHOHHHOH
HOOHHHHHHHHOHOHOHOHHOOHOOOHHOHHOHOOHHOHOOOOHHOOOOOOHHOOHHOOOHHOOHHOHHOHHOOHHOHHOOOOHOHHOOOOOOOOOHOOH
HHOOHOHOHOHHHOHOOOHHHOHOHHHOOHOOOOHHHHHOHHHHHHHHOHOOHHOOOOHOOHHOOOOHOOOHOHHOOOOOHHOHOHHOHOHHOHOHHOHH
HHOHHOOOOOOHHOOOHHHOOOHOOHHHOHOHHOHOOHHOHOOHHOHHHHHOOHHHOHHHOHHHHHOHHHOHOOHHOHHHHHHHOOOOHHHHHHHHHOHH
HOOOHHHHHHOHOOHOOHHHHOHOHHOHHHHHHOHOHHOOHOHHOOHOHHHHOOHHHHHHOHOHOHOHOHOOOHHHOOOOOOOOOHHHHHHHHOHOHOOH
HHHOOHHOOOOHHHHHOOHOHOHOHOOOHOHOOOOOOHHOOOOHHOHOOHOHOHHOHOHOOHOOOOOHOHOHHHHOOHOHHHHHHHHHHOHHOOOOHHOH
HHHHOOHHHHOOHHOOOHHOOOOOOOHHHOHHHHHOHHHOHHHHHOHOHHOOOOHOHOHHOHHHHHOHOHOOOOHHOHHHHHOHHHOOHOHHOHHHHOOH
HOOOOHHOHHHOHOOHOOOOHHHHHHHOHOOHOHHOOOHOHOHOHOOOHHHOHOOOHOHHOHHHHOOHOHOHOHHOOOHOOOOOOHHOHOHOOOHHOOHH
HHHHOHOOOOOOOOHHHHHOOHOHOHHOHHOHOOOOHHHOHOOOHHOHHOHHHHHOOOOOOHOOHHOHOHOHHHHHOHHOHHHHOHOOHOOOHHHHHOOH
HOOOOOOHHHHHHHHHOHHHOHOHOOHOHOOHHOHHHHOOOOHHHHOHOOHHOOHHHHHHOHOHHOOHOHOHHOHOOHOOOHHHOHHOHOHHHOHHOOHH
HHHHOHOHHOHOOOOOOOOHOOOHOHHOHOHHOOOOOHHHHOOHOHOOOHHOOHHOHHHOOOOOHHOHOOOOHOHHOOOHHHOHHHHOHOOHOOOHHOOH
HOHHHHHHOOHHHHOHOHOOOHHHOHOOOOHOOHHHHHHOHOHHOHHOHHHOHHHOHOHHHHHOHHOHOHHHHOOOOHOOOOOOHHOOHOHHOHHHOOHH
HOHOOHHHOHHOOHHHHHHHOOHHOHHHHOOOHHHHHHOOOOHHOHOOOHOOHHOOOOOOOOOOOHOHOHHOHHOHHHHOHHHHHHHOHOOOOHHOOHHH
HOHOHHOHOOOOHHHOHOOOOHHOOHHOOOHOOHOOOHHHOHHOOHHHOHHOOHOHHOHHOHOHOHOOOOOOOOOOOOHOOHHOHOHOOOHHHHHOHHHH
HOHOHOOHHOHHHHOOHHHHOHHOHHHHHHHHOOOHHHOHOOHHOHOHOOHHOHHHHHHHHHHHOHHHOHHHHHOHHOHHOHOOOOOOHHHOHOHOHOHH
HOHOHHOHOOHHOHHOHHHOOHHOHHOHOHOHOHOHOOOHOHHOOOOHOHHOOOHHOHOOHOHOOOOOOHHHOHHHHHHHHHHOHHHHHHOOOOOOOOOH
HOOOOHOHOHHOOOOOHOHHOOOOHHOHOOOHOHHHHHOHOHHHHHOHOOHHOHHHOHHOHOHHHHHHOOOOOOOOOHHOHOHOHHOHHOOHHHHHHHOH
HHHHOOOOOOHHHOHHHOOOOHHHHOOHHHOOOOHHOOOOOHOHOOOOOHHOOHHOOOOOHOHHOOOOOHHHHHHHHHOOOOOOHHOHHOHHOHHHHHHH
HOOOOHHOHHHHOOHHHHHHOOOOHHOHOOOHOHHHHHOHHHOHHOHOHHHHOOHHHHHOHOOHHOHHOOOOOOOOOHHHHOHHHOOHOOHHOHOOOHHH
HHHHHHHOHHOHOHHOHHOHHHOHHOOHHHOHHHOHHOOOHHOHHHHOOHHOOHHOHOHOHOHHHHHHOHHHHHHHHHOHHOOHHHOHHOOHOOOHHHOH
HHOHHOOOHHOHOHHOOOOOHHOHOOHHHOOOHOOOHHHOHHOOHHOOHHHHOHHOOOHOHOOHOHOOOOHOOOHOOHOHHOHHOHOHHHOHOHHHOHOH
HOOOOOHOOOOHOHHHOHHOOOOOOHHOHOHOOOHHHHHOHHHOOOOHHHOOOHHOHOOOOOHHOHHHOHHOHHHOHHOOOOOHOHOOHHOHOHOHOHOH
HHOHOHHHOHOOOOHHHHHHOHOHOHHOHHHHOHHOOOOOOHHHOHOHOHHHOOHHHHHHHOHHOOHHOHHOOHHOOHHHHHOOOOOHHHOOOOOHOOOH
HOOHOHOOOHHHHOHOHOHHHHHHOHHOHHHHOOHHHHHHOHOHHHOHOOHHHOHHOHHOHOOHOHHOOOHOHHOOHHOHHOOHHHHHOHOHHHOOOHHH
HOHHHHHHOHOOOOOOHOHOHOHOOOHOHOHOOHHHOHOOOOOHHOOOOHHOHOHOOHHOHOHHOOHHHOOOHHOHHOOOHHOHOHOHOHOHOHHHHHHH
HHHOHHOHHHHHOHHOOOOOOOHHHOOOHOHHOOOHOHHHOHHHHHHOHHOOHOHHOOOOOOOHHOHOHOHHHOOOHHOHHOOOOHOHOOOOOOHOHOOH
HHOOOOOOHOHOOHHHOHHOHOOOOOHOOOOOOHHHOOHHOOHHOHOOOHHOOOOHHOHHHOHHOOOOHOOHHOHHHHOOHHOHHHOHOHHHHHHOHOHH
HOOHOHHOOOOOHHOOOHOOHOHHOHHHOHOHOHOHOHHOOHHOOHHOHHHHOHHHHHHHOOOOOHHOOOHHOOOOOHHOHHOHHOOOOOOOHHHOHOHH
HHHHOHOOHOHOHHOHOHHHHOHHHHOHHHHHOHOOOOHHOOHHOHOOOHOHOHHOHHOHHHHHHHHOHHHHHOHHHHHOOHOOOOHHHHHHHOOOOOOH
HOOOOHHOHHHHHHHHHHHHOOHOHHOHHOHOOHOHOHHHOHHOOOOHHHOOOHHOOHOOOHHHOOOOHHHHHOOHHOHHOHOHHOOOOHOHHHOHHOHH
HOHHOHHOHOOHOHHOHHOHHHHOOOOHHOHOHHOHHHOOOOHHOHHHOHHHOOHHOHHOHHOHHHHOHOHHOOHHOOHHOOOHHHHOHHOHOOOOHHHH
HOHHOHHOHHOOOOOOOOOHOHHHHHOOOOOOOOOOHHHHHOHHOHOHOOHHOHHOOHHOOHOHOOOOHOOHHOOHHOHOOHOHOHHOHHOHHHOHHHOH
HHHHHHHOHHHOHOHOHHOOOHOOOHHOHOHOHHHOHOHOHOHHOHOHOHHOOOHHOHHOHHOHHHHOOOHHHOHHHOHOHHHHOOHHHHOHOHOOOOOH
HOOOOOOOHOOOHOHHHHHHOHOHHHOOHOHOHHOOOOOOHOHHOHOOOOHHOHHOOOOOOOOOHHHHOHHOHOHHOOHOHOHHOHHHHOOHOHOHHHHH
HOHOHOHHHHHOHHHHOOOOOOOOOOOHHOHOHHHHHHHOHOHHOOOHHHHHOHHHHHHOHOHOHOOOOHHOHOHHOHHOHOHOOOOOHHOOOOOHOHOH
HHHHHHHHOHHHHHOHHHHOHHHHHOHHOOHOHOOOOOOOHOHHHHOOHOHOOOHOHHOOHHHHHHHHOOOOHOHOOHHOOOOOHHHHHHHOHHHHOOOH
HHHHOHOOOOOOOOOOHHHHHOOOOOOHOHHHHHHHHHHOOOOHHOOHHOHHHOOOOHHOHHOHOHOHHHHOOOOOHHOOHHHHHOHHOHHOHHOHOHHH
HOHOOHHHOHHHHHHOOOHOOOHHOHHHHHHHOHOHHHHHHHOOHHOOHOHOHHHHOOHOHOOHOHOOOHHOHHHHHHHOOOOHHOOHOHOOHHOOOHOH
HOOOHHOHHHHHOOHHHOOOHOOHHHHHHOHOOOOHOOOHOHHOHHOHHOHOHOOOOHHOHHOHOHHHOHOOOHHOHHOOHOHHOOHHOHOHHHOHHHOH
HHHOHOOOHHOHHOOOOOHOHOHHHHOHOOHOHHOHHHOHOHOOOOOHHOHOHHOHOOHOHOOOOHHOOOOHHHHOOOOHHHHHOHHOOHOOHOOOOHOH
HOOOOOHOOOOOOOHOHOHOHHHOOOOHHOHHHHOOOOOOOOOHHHOOHOHOOHOHHOOOHHHHOHHHHOHHHOHOHHHHOHOHOOHHOHOHHOHHHHOH
HHHHHHHOHHOHOHHOHOHHHHOOHHOOOOOHOHHHHOHOHHOHOOOHHOHOHHHHOOHHHOHOOOHHHOOOHOHOOOHHOOOHHOHOOOOHHOOHOOOH
HOOOOOOOOHHHOHHHHHHHOHHHHHHHOHOOOOOOOOHOHOOHOHOHHOHOOHHOOHHHOOHHHOOOHOHOHOHOHHHHOHHHHOOOHHHHHOHHOHHH
HHHOHHHOHHOOOHOOOOOOOOHHHOHHHHHOHHHOHOHOHHOHHHOHHOHHOHHHOOOHHOHOHHOHHOHHHOOOHOOOOHHOHHOHHOHOHOOOOOHH
HHHOHOOOHHHHHHHHHHHOHOOOHOOOHOHHHOOOHHHHHHHHHOOOHOHOOHOHHOHHOOHOOOOHHOOHHHHOHOHHHHHOOOOOOOOOOOHOHOOH
HOHHHHOHHOOOOOHOHHOOHHHOHHHOHOOOOOHOHHOOOHOOOOHOHOHHOHOHOOOHHOHHHHOOHHOHOHOOOOOOHOHOHOHOHHHHOHHHHOHH
HOOHOHHHHHHHHOOOOHHHHOOOOOOOHOHHHHHHHHHHOOOHOHHOOOOOOOOHHOHHOOHHOHOHHHOHOOOHOHHHHOHHHOHHHHOHHHOOHOOH
HHOOOHHHOOHHHHHOHHOHHHHHHHHOHHHHHOOHHOHHHHOHHHHHOHOHHHOHHOHOOHHHOHOHOHOHOHHHHHOHHOOHOOOOOOOOOOOHHHHH
HHHHOHOHHOOOOOOOOOOOHHOHOOOOHHOOHHOHOOOOOHHHHOHHOHHHHOOOOOHHOHOHOHOOOOOOOOOHHHOOHHOOOHOHHHOHOHHHOOOH
HOOOOOOHHHHHHHHHHHHOHOOOOHHOOHHOHHOHOHHOHHHOOOHHHHOOOOHHHOOOOOOOOHOHHHHHHHHHOHOHHOOHOHOOOHOHOHOOOHHH
HHHHHHOHOHHHOOOOOOOOOOHHOHHHOOOOOHOHHHOOOOHHHOOOHHHHHHHHOOHOHHOHOOOOHOHHOHHOOOOOOOHHHHHHHHHHOOOHHHOH
HOHOOOOOOOOOOHHHHHHHHOHHHHOHHHHHOOOOHHHHHOOOHHHOOOOHOOOOOHHOHHOHHOHHHOHHOOHOHHHOHOHHHHHHOOHHOHOOOOOH
HOHHHHHHHHOHOHOOOOOOOOOHHOOOOOOOOHHOOHOHOOHOOHHHHHOHHHHHOHHOHOOHOOOHHOOOOHHOOOHHHOOHOHOOOHHHOHOHHOHH
HOOOHOHOOOOHHHHOHOHOHHOHHOHHHHHOHHHHOOOOOHHHOOHHHOOOOOHHOOHHHHHHHHOOOOHHHHOOHOOOHHOOOOOHOOOHHHOOHOOH
HOHOHOOOHOHHHOHOHOHOHHOHOOHOOOOOHOOOOHOHHHOHHOHOOOHHHOHHOHHOOOOOOOOHOHHHHOOHHHOHHHHOHOHHOHHHHOOHHOHH
HHHOOOHOHHHHOOOOHOHHHHHHHOHOHHOHHHOHOHOHOOOOOOOOHOHOOOOOOOHHOHHOHOHHOOOOOOHHOOOOOOHOHOOHOOOOHHOOHOOH
HOOOHOHOHOOOOHHOHHHHHOHHHHHHHOOHOOOHOHOHHOHOHOHOHOHHHHOHOHHHHHHOHOOHOHOHOHHHHHHOHHHHHHOHOHHHHOOHHOHH
HHHOHOHOHHOHHHHHHHHOOOOHHOOHOOHHHOHHOHHHOOHHHOHOHHHHHOOHHHOOHHOOHHOHOHOHOOOOHHHOOOOOOHOHOOOOHHHHHHHH
HOHOHOHHHHHHHOHHOOHHHHOOHHOHHOHHOOHHOOHHOHHHHHHOHHOOOOHHHHHOOOOHHOOHHHOHOHHHHOHOHHHHHHHHHOHHHOHOOOOH
HOOOHHHHHOHOOOOHHOHOHHHOOOOOOOHHHOOHHOHOOHOOOOOOOHHOHOHHOOHHHHOOHOHHHHOHOOOOOOHOOOOOOOHHOOOOOOOOHHOH
HHHOHHOOOOOOHHOOOOHOHOOOHOHOHOHOOOHHOOHOHHOHHOHOHHOOHOOHHOOOOOOHHHHHOOOHOHOHHHHHHHHHHHHHHOHHHHOHHOOH
HHHOOHHOHOHOHHHHHOHOOOHOHOHOHOHOHOOHHOHOHHHHOOHHHHHOHHHHOOHHHOHHOHOHOHOHOHOOOOOOOOOHHOHOHHHHHHHHHHHH
HOHOHHOOHOHOHOOOOOHHHHHOHHHOHOHOHHOOHHHOHOHHHOHOOOOOHOOOOHHHOOOOOOOHHHOHHHHOHOHHHHOOOOOOHHHOOOHOHHHH
HOOOHHHHHHHOHHHHHOOOOOOOHOOOHOHOHHHOHOOOHOOOHHHHHHHHHHHOHHOOOHOHOHHHHHOOHOHHHOHHHHHHOHHOOOOOHOOOOOOH
HHHHHOOHOOOOHOOOOOHHHOHOHHOHHHHOHOOOHHOHHHHOHHOHOOOOOOOOOHHHHHOHOOOOOHHOOOOOHOOOOOOHOOHHOHOHHHOHHHHH
HOHHHHOOOHHOHOHOHOHHOOHOHOOOHHOOHHHOHHHHOOOOOOOOOHOHHHHHHHHHOOOHOHHOHHHHOHOHHOHOHOHHHOHHOHHHOHOOOOOH
HOOOOOOHOHHHHHHOHOHHHHHHHHOHHHHOHHHHHOHHHHHHOHOHOHHHOHHHOHOOOHHHOOHOOHHOOHOHHHHOHOOOHHHOOOOOOHHHHHHH
HOHOHHHHHHOHOHOOHHHOHHOHOOOHOHOOHOOOOOOOOOHHHHHHHHOOOOOOOOOHOOHHOHHHHHHHHHOOOOHOHOHOOOHHOHOHHHHOOHOH
HHHHHOOOOOOOOOOHHOOOOOOOOHHHOHHHHOHHHOHOHOOOOOOOOOOHHHOHOHOHHOHHOOOHHHHHHOOHOHHOHOHOHOOHOHOHHOHOHHOH
HHOOOOHOHHHHOHOHHHHHOHOHOOOOOOHHHOHHHHHOHOHOHOHHHOHHOOOHOHHHOOHOOHHHOHHOHOHHOOHOHHHOHHOHOHOOOOOOOOOH
HOOHOHHOHOOOOHHHOHHHOHHHOHHOHHHOHHHOOOOOHHHHHHHOOOHHOHOHOHHHHOHHOOOOOOOOHOHHOHHHHHHOOHOHOHOHOHHOHOHH
HOHHHHHHHHHHOHOOOOOOOHOOOOHOHOOOHHOOHHOHHHOHOHOOHOOHHHHHHHOOOOOHHOHOHHHHHOHHOOOOOOHHHHOHHHOHHHOOHOHH
HOHOOOOOOOOOOHHHOHHOHHHHOHHOHOHOOOOHHOOHHOOOOOOHHOHHHHOOOOOHHOHHHHHOOOOOHOHHOHOHOHHHHHOHHHOOOHHOHOOH
HGHHOHOHHOHOHHOOOHOOHHOOOHOOHOHHOHOOHHOHOOHOHHOOHOHOOOOHOHOHOOHHOOOOHHOHHOOHOHOHOOOOOHOOOHOHOHOOHHOH
HHHHHHHHHHHHHHHHHHHHHHHHHHHHHHHHHHHHHHHHHHHHHHHHHHHHHHHHHHHHHHHHHHHHHHHHHHHHHHHHHHHHHHHHHHHHHHHHHHHH
