HHHHHHHHHH
HSOOOOOOOH
HOHHOHHHOH
HOHHHHOHOH
HOHOHHOOOH
HOHOOOOHOH
HOHHOHOHOH
HOHOOHOHOH
HGHHOHOHOH
HHHHHHHHHH
