HHHHHHHHHH
HSOHHOHHOH
HHOHOOOHOH
HHOHHOHHOH
HOOHOOOHOH
HHOHHOHHOH
HOOOOOOOOH
HHHHHHHHOH
HOOOOOOOGH
HHHHHHHHHH