HHHHHHHHHH
HOOOOOOOSH
HHHHHHHHOH
HOOOOOOOOH
HHOHHHHHOH
HHHHHHOOOH
HOOOOOOHOH
HHHHOHHHOH
HGOOOHHOOH
HHHHHHHHHH
