HHHHHHHHHHHHHHHHHHHH
HOOOHHOHHOOOOOOOOOSH
HOHHHOOOHHOHHHHHHHHH
HOOHOOHOOHOOOOOOOHOH
HHOOOHHHOOOHHHHHOOOH
HOOHOOOHOHOOHOHHHHHH
HOHHOHOHOHHOOOOOOHHH
HOHHOHOHOOHOHHOHHHOH
HOHHOHOHOHHOOHOHHOOH
HHHOOHHHOOHOHHHHHOHH
HHHHOHHHOHHOOOHHOOOH
HOOOOOOHOOHOHOOOOHHH
HOHHOHOHHHHOHHOHOOOH
HOHHHHOHHOOOOHOHHOHH
HOHOHHOOHHHOHHOHHOOH
HHHOOOOHHOOOOHHHOOHH
HHHHOHHHHHOHOOHHHHHH
HOOOOOOHOHOHHOOOOOOH
HOHHOHOOOHOOHHOHOHGH
HHHHHHHHHHHHHHHHHHHH
