HHHHHHHHHHHHHHHHHHHH
HOHOHOHOOHHOOOOOOOSH
HOOOHOOOHHHOHHHHHHOH
HOHOOOHOOOOOOHOHHHHH
HHHHHOHHOHOHOOOOOHHH
HOOOOOHHOHOHHOHHHHOH
HHHHOHHHHHOHHOOOOOOH
HHHHOOHHOOOHHOHOHOHH
HOOOOHHOOHOHHOHHHOHH
HHHOHHHHOHOHOOHHOOOH
HOOOHOHHHHOHHOOHHHHH
HHHOOOHOHOOHHHOOOOOH
HHHHOHHOOOHHOOOHOHHH
HOOOOHOOHOOHHOHHOHOH
HHHHOHHOHOHHOOHHOOOH
HOOOOHHOHOHHHOHOOHOH
HHHOHHOOHOHOOOHHOHOH
HHHOHOOHHHHHOHHHOHOH
HOOOHHOOOHHOOHOOOHGH
HHHHHHHHHHHHHHHHHHHH