HHHHHHHHHHHHHHHHHHHHHHHHHHHHHHHHHHHHHHHH
HOOOOOHHOHHOHOOOOOHOHOHOHHOOOOOOOOHHOHSH
HHHOHOOHOOHOHOHHHHHOHOHOHHOHHHHHHHHOOOOH
HHHOHHOHHOOOHOHOOOOOOOOOOOOOOOHOHHHHHHOH
HOHHHOOHHOHOOOOOHOHOHOHHHHHHHHHOOOHOHOOH
HOOHHHOOHHHHOHOHHOHHHHHHOHOHHHOOHHHOOOHH
HOHHOHHOHHOOOHHHHOHOOHHOOOOOOHOHHHOOHOOH
HOHHOOOOOHHHOOHOHHHHOHHOHHOHOOOOOOOHHHOH
HOOHHHHOHHOHOHHOOHHOOOOOOHHHHHHHHHHHOHHH
HOHHOOOOOOOOOOOOHHHOHHHHOOHHOOOHOOOOOOHH
HOHHHHHHHHOHHOHHHOHOOHHHHOOHHHOOOHHHHOOH
HOOOHHOHHOOHHOOOOOOOHHOHHHHHOHOHOOOOHHHH
HHHOHOOOHHHHHOHHHHHHHOOOOHHHOHOHHHOHHHHH
HOHOHHOHHHOOOOOOOOOOOOHHHHOOOHOOOHOOOOOH
HOHOHOOOOHHHOHOHHHHHOHHOOHHHOOOHHHHHHHHH
HOHOHOHHHHHOOHHHOHOHHHHOHHOOOHHHHOHOOHOH
HOOOHOOHHOHHOHHHOOOOHOHOOHHHOHHOHOOOHHOH
HHOHHOHHHOOHOOOHHOHHHOHOHHHOOOOOOOHOOHOH
HOOOHOHOHHOOOHHHOOHHHOHOHOHHOHHHHHHHHHOH
HHHOHOHOOHHOHHOHHOHOOOOOOOHOOOHHOOHHOHOH
HHOOOOOOHHOOOHOHHOOOHHHHHOOOHHHHOHHOOOOH
HOOHOHHOOHHOHHOOOOHOOOOOHHOHHHHOOOOOHHHH
HHHHHHHHOOHOHHOHHHHHHHHHHHOOOOHHOHHHHOOH
HHHOHHOHOHHOHHOOHHHOOOOOOHHHHHHOOOOOHHOH
HOHOOOOOOOHOHHHOHOHHOHHHHHOOHHOOHHHHHOOH
HOHHHOHHOHHOHOHOOOOOOOHOOHHOOHHOOOHOHOHH
HOHOHHHHOHHOHOHOHHHHHHHOHHHHOHHOHHHOHOOH
HOOOHHHOOOHOHOHOHOHHOHHOOHOHOHHOOHHOHOHH
HHHOHOHOHOOOHOHOHOHOOOHHOHOHOOOOHHHOOOOH
HOOOOOOOHHHOOOOOHOOOHOOOOHOHOHHHHHOOHOHH
HHHOHOHHHHOOHHHOOOHHHHHHHHOOOOOOOOOHHHHH
HOHHHHHHOHHOOOHHOHHHOHOHOHOHHHHHHHOHOHOH
HOHHOHHOOOOOHOHHOOOOOOOOOOOOOOOOOHOHOOOH
HOOOOOHHHOHOHHHHOHHOHHOHOHOHHHHHHHHHOHOH
HHOHHOOOOOHOHHOOOOHOOHOHOHHHHOHOHOHHOHHH
HHHHHHOHHOHHHOOHOHHOHHHHOOOOOOOOOOOOOOHH
HHHHHOOHHOHHHHOHHHOOOOHHHHOHHHHHOHOHHOOH
HHOHOOHHHOOOHHOHHHHHOHHOHHHHHOHHHHOHHHOH
HGOOOHHOOOHOHOOOOHHOOOOOOOOOOOOOHHOHOOOH
HHHHHHHHHHHHHHHHHHHHHHHHHHHHHHHHHHHHHHHH
