HHHHHHHHHHHHHHHHHHHHHHHHHHHHHHHHHHHHHHHHHHHHHHHHHH
HOOOOHHOHOHOOHHOHOHHOOHHOOOHHOHHOHHOOHOHHOOOOHOHSH
HHOHHHOOHOHHOOHOOOOHHOHHHHOHHOOHOHHHOOOOHHOHHHOHOH
HOOOOHHOOOOHHOOOHHHHOOOHHOOOOOHHOOOOOHHOOOOOHHOHOH
HOHHHHOOHHHHOOHHHHHOOHHHHHHOHHHHOHHHHHHHHHHHHOOHOH
HOHHOHHOOOOHHOHHHOHHOHOOHHOOOOOOOOOOOOOHHOHHOOHHOH
HOHOOOHOHHHHOOHOHOHOOHOHHHHHOHHHOHHHOHOOHOOHOHHOOH
HOHOHHHOOHOHHOOOOOHOHHOOOOHHOHHHHHHHHHHHHOHHOHOOHH
HOHOOHOOHHOHOOHOHHHOOHHOHHHHOHOHHOOOHOHOHOHHOOOHHH
HOOOHHOHHHOHOHHHHOHOHHOOOHOHOOOOOOHHHOOOHOHHOHHHOH
HHHOHHOHHOOOOOHHOOHOOHHOHHOHOHHHHHHOHHHOHOHOOOOOOH
HOOOOHOHOOHOHHHHHOOOHHHOHHOOOOOOOOOOOHOOOOOOHHOHOH
HHHOHHOHOHHHHOHOHHHOOOOOOOOHHHOHHHHHHHOHOHOHHHHHOH
HOOOOHOHOOHHOOHOHOHOHHHOHHOOOHHHHHOOOOOHHHOOOOOHHH
HHHHOOOOOHHOOHHOHOHOHHHHHHHHHHHHOHOHHHOOOHOHOHHHHH
HHOHOHHHOOHHOHHOHOHOOOOOOHHHHOOHOOOOOHHHHHOHOOOOOH
HOOOOHOHHOOHOHHOHOOOHOHOHHOOOOHHOHHHHHHHHHHHHHHOHH
HHHHOHOHHHHHOHOOOOHHHHHHHHOHHHHHOHHOHOOOOHHOOOHOHH
HOOOOOOOOHHOOHOHHOOHOHOOOHOHOHOOOOOOOOHHHHOOHOHOOH
HHHHHOHHHHHHOHOHHHOOOHHHOHOHOOOHHHHHHHHHOOOHHHHOHH
HOOOHOOOOHHOOHOOHHHHHHHOOHOOOHOOOOOOOOOOOHOOOOHHHH
HHHOOOHHHHHHOHOHHOHHHOHHOHOHHHOHHOHHHHHHHHHOHHHHOH
HHHOHOHOHHOHOHOOOOOOOOOOOOOOOHOHHOOOOOOOOHHHHHOOOH
HOHHHOOOOOOOOOOHHHHHOHHHOHOHHHOOHOHOHHHHHHOHOHHOHH
HOHHOOHHHOHOHOHHHHHHOOOHOHOHHOOHHHHOOOOHOHOOOOOOOH
HOOOOHHHHHHOHOOOOOOHOHOHHHOHHHOHOOHHOHOOOOOHOHHHOH
HHHHOOOOOOHOHOHHHHOHHHOOHHOOHHOOOHHHHHHHOHOHOOOHHH
HOOOOHOHHHHOHOOOOHOOOHHOOHHHHHHHOOHOHOOHHHHHHHOOOH
HOHHOHOOHHHHHHOHHHHHHHHOHHHHHOOOOHHOHOHHHHOOHHHHHH
HOHOOHHOOOOOHHOOOOOOOOHOOOOOHHOHOOOOOOOHOHHOOOOOOH
HOHOHHHOHHHHHHOHHOHHOHHHHHHHHHHHOHOHHHOOOOHOHHHHHH
HOHOHHOOOOOOOHOHOOOHOOOHHOHHHHHHHHOOOHOHHOOOOHHHHH
HOHOOHHOHHHOHHHHHOHHOHHHOOOOHHOOOOOHOHOOHHOHHHOOOH
HOHOHHHOHHOOOOHOHHHHHHHHOHHHHHHHOHOHHHHOHHOHHOOHHH
HOHOHOOOOHHOHHHOOHOHHOOOOOOOOOHHOHOOOOHHHOOOOOHHHH
HOHHHHOHOHHOHOHOHHOOOOHHOHHHHOHHOHOHHHHHHHOHHHHOOH
HHHHOOOHOHHOOOOOHOOHHHHHOOOOHOOHHHOOOHHOOOOOOOHHOH
HOOOOHOHOOHHOHHOHOHHHHOOOHHHHOHHOOOHOOHHHHOHHOOHOH
HOHOHHOHHHHOOOHOOOOOOHHHOHHHHHHHHHOHHOHOHHOOHHOOOH
HOHOHOOOHHHHOHHOHHOHOOHHOOOOOOOHHOOHHOOOOHHHHHOHOH
HOHOHHHOHOHHOOHOOHOHHOHHOHHOHOHHOOHHOOHHOOHHOHHHHH
HOHOHOOOOOHHHOHOHHOOHHHHHHHHHHHHHOOHHOHHHOOOOOHOHH
HOHOHOHOHOOHHOHHHHHHHHOOOOOHOHOOHOHHOOOHHOHOHOOOOH
HHHHHOHOHOHHOOOOOOOOOOOHOHOOOOOHHOOHHOHHHOHHHHHHHH
HHOOOOHOHOOHHOHHHHOHHOHHOHOHHHHHHHHHOOHHOOOOOOOOOH
HOOHOHHOHOHHOOOOOHOOHHHHOHOOOOHOOOHHHOOHHOHHOHOHHH
HHOHOOHHHOHHOHOHHHHOOHOHHHHOHOOOHOOOHHOHOOOHHHOOOH
HOOHOHHOOOHHOHOOOOHHOOOHHOOOHOHHHHOHHOOHHOHHHHHOHH
HOHHOHHOHOOHOHOHOHHHHOHHOOHOHOOOHHOOHHOHHOOOOOHOGH
HHHHHHHHHHHHHHHHHHHHHHHHHHHHHHHHHHHHHHHHHHHHHHHHHH
