HHHHHHHHHHHHHHHHHHHHHHHHHHHHHHHHHHHHHHHHHHHHHHHHHHHHHHHHHHHH
HOOHHOHOOOOHOHOHOOOOOHHOHOOOHOOOOOOHOHOOHOHHOHOHOHOHOHOOHOSH
HHOHHOHHHHOHOHOHOHHHHHHOOOHHHOHHHHHHOHOHHOHOOOOOOOOHOHHOOOHH
HOOOHOHHOOOHOOOHOHHHOOOOHHHOHOHHOHOHOHOHHOOOHHHHHHOOOOOOHOOH
HHHOHOOHHHOHHHOOOOOHHHHOHOOOOOOOOOOOOOOOHOHHHHOHOHHHOHHHHHHH
HOOOOOHHOOOHHOOHOHOOOHHOOOHOHHOHOHOHHOHOOOOHOHOOOOHHHHOOOHHH
HHHOHHHHHHOHHOHHHHHOHHHOHHHOHHHHOHOOHOHHOHOOOOOHHHHOHHOHHHOH
HOOOOOHOHOOHHOHHHHHHHOHOHHHOHOHHHHHHHHHHHHOHOHOOHHOOOOOOOOOH
HHHOHHHOHHOHHOOHOHOHOOOOOOHHHOHOHOHHOOOOOHHHOHHHHHOHHHHHHHHH
HOOOHOHOOHOHOOHHOOOHOHHOHOOHOOOOOOOOOHHHHHHHOHHHOOOOOOOOOOOH
HHHOOOHHOOOHOHHOOHOOOOHOHHOOOHHHHHHHHHHHOHOOOOOOOHOHHHOHHHHH
HHOOHHHHHHOHOOOOHHOHHHHHHOOHHHHHOOHHHOOOOHHHOHOHOHHHOOOOOOOH
HOOHHOOHOHOHHOHHHHOOHOOOHHOOHOOOOHHOHOHHHHHHHHOHOOOHHHHHOHOH
HHOOHHOHOOOHOOHHOHHHHOHHHHHOOOHHOOOOOOOHHHOHHHHHHHOOOOOHOHOH
HHHOOOOHOHOHOHHOOHHHOOOOHOHHHHHOOHHHOHOOOHOOOOOOOHOHOHOHHHOH
HOOOHHHHHHOHOOHOHHOHOHHHHOHHOHHHOOOHOHOHOHOHHOHHOHOHOHOOHHOH
HHHOHOHOHOOHOHHOOOOOOOOHOOHHOOOHHOHHHHHHOOOOHHHHOHOHOHOHHHOH
HOHOHOHOHHOOOOOOHOHOHHHHOHHOOHOHHHHOHOOHHOHOOHOHHHHHHHOOOHOH
HOHOHOOOHHOHHHOHHHHOOHHHOHHOHHHHOHOOHOHHHHHHOOOHHOOHHHHHOHOH
HOHOHOHHHOOOOHOOOOHHHHOHOOOOOOHHOOOHHOOOOOHHHHOOOOHHOOHHHHHH
HOHOOOHOHOHHHHOHHHHHHHOHOHHHHOOOOHHHOOHHHHHOOHHHOHHHOHHOHOHH
HOHOHHHOOOOOOHHHHOHOOOOOOHOOHOHOHHHOOHHOHOHOHHHHHHHOOOOOOOOH
HOHOOOHHOHHHHHHOOOOOHHHHOOOHHHHOHOHHOHOOOOOOOOOOHHOOHOHHHHHH
HOHOHHHHOOOHHOHOHHHOOOOHHHOOOOHHHOOOOOOHHHHHHHHOOOOHHOHHHOHH
HOHOHOHOOHOOOOOOOHHHHOHHHHOHOHHHHHOHHHOOHOHOOHHHHHHHOOHOHOOH
HOOOOOOOHHHHOHOHOHOHHHHHOHHHHHHOHOOOHHHOHOOOHHOHHOHHOHHOOOHH
HOHOHHHHHHHHHHHHOOOOOHOHOHHOHOOOOOHOOOHHHHOHHOOOOOOHHHHOHHHH
HHHOHHOHOHOOOHHHHOHOHHOOOOHOOOHHHHHOHOOHOHOHHOHOHHOOHHOOOOOH
HHOOHOOOOOOHHHOHHHHHHHHOHHHOHHHHOHHHHHOOOOOHOOHHHHHOOHOHHHOH
HOOHHOHOHOHHHOOOOOOHHOOOOOOOOOOOOOOHHHHHOHOOOHHHOHHHHHOHOHHH
HHOHOOHHHHHOHOHHHOHHHHOHHOHOHHOHHHOOHOHHHHOHHHOOOOOOOOOOOOHH
HOOOOHHHOHHOHOHHHHHOHOOHHHHHHOOHHHHOOOOHHHHHHHHHHOHOHHHOHOOH
HOHHOOOOOOHOOOOOOHHOHOHHOHHHHHOOOOHHHHOOOOHHOHHOHOHHHOHHHHHH
HOHHOHHHOHHOHHHHHHHOOOOOOOHOHHHOHHHHHHHHHHHHOHOOOOOHHOOOHHOH
HOHHOHOHOOOOHHHOHOHOHHHHHOOOOOHOOOHOOOOOHHHOOHOHHHOOOOHHHOOH
HOHOOOOHHOHOHOOOOOOOOOOOHHOHOHHHHOOOHOHHHOHHOOOOOHOHHOOOOOHH
HHHOHHOHHOHOOOHOHOHHHOHHHHHHHHHHHHOHHHHHOOOOOHHHHHHHHOHOHHHH
HOOOHHOOHHHOHHHHHOOOHHHHHOHOHOHOHHHHOHHOOHOHOOOHHOHOHHHHHHOH
HHHOOHOHHHHOOOOHHOHOOOOOOOOOOOOOOOHHOHOOHHHHHHOOOOOOOHOHHOOH
HOOOHHOOOOHHOHOHOOHHHOHOHHHHHHHHHHHHOOOHHOHOHHHHHHHHHHOOOOHH
HOHOHHHOHHHHHHHHHOOOHHHHHHHHOHHOOOOOOHHHOOOOOHHOHHHHHOOHHOOH
HHHHHOOOOOOOOOOHHOHOOOOOOOOOOOOOHHHHHHOHHOHHHHOOOOOOOOHHHHHH
HOOHHHOHHHOHHOHHOOHOHOHHOHOHOHHOHHHHHOOOOOOOOOOHOHHHHOOOOHOH
HHOOOOOOOHOOHOHOOHHHHHHOOHOHOOHOOOOOOOHOHHOHHHHHOOOOHHHHOHOH
HOOHHHOHHHHHHOHHOOOOOHHHOHOHOHHOHHOHOHHHHOOOOOOHOHOHHHOHHHOH
HHOHHOOOOHHOHHHHOHHOHHOHHHHHOHHOOHHHOHOHHHOHHHHHHHOHOHOOHHOH
HOOOHHOHOOOOOHHOOHHOOOOOOOOHOHHOHHOOOOOOHHOOOOOOHHOOOOOHHHOH
HHOHHHOHOHOHHHHHOOHHOHHOHOHHOOHOOHHOHOHOHHHOHOHHHOOHOHOOOOOH
HOOOOHOHOHOOOHOHHHHOOHHOHHHHOHHOHHHOHOHOOOHHHOOHHOHHOHHHOHHH
HOHOHHHHHHOHHHOOOOHOHHOOOOOHOOHOOOHOHOHOHOOOHHOOHOHHOOOHOOOH
HOHOOHHOOOOOHHOHHHHHHOOHOHHHOHHHOHHOHOHOHHHHHOOHHOOHHOHHOHOH
HOHHOHOOHOHOOHOOOOOOHHHHOOHHOHOHHHOOHOHOOOOHHHHHHHOHHHHHOHHH
HOHHOHHOHHHOHHOHHHOHHHHHHHHOOOOOOHHHHOHOHHOOOOHOHHHHOHHOOOOH
HOHHOHHHHOOOOOOOOHHHHOOHHOHHOHHHHHOHHHHHHHHOHOOOHOHOOOHHHHHH
HOOHOOHHOOHOHHOHOOHOHHOOHOHHOOOOOOOOOOOOOHHOHHHOOOOOHOOOOOOH
HHOHHOHOOHHOHHOHHOOOOHOHHOHHHHHOHOHOHOHOHHHOOHHOHHOHHHHHHHHH
HOOOHHHHOHHOHHOOHOHHOOOHHOOOHOHHHHHHHOHHHHOOHHOOHHOOOOOOOHHH
HHOHHOOOOHHOOHOHHOOHOHOOOOHOOOOHOHOHHHHHOHHOOHHOOHHHHOHHHHOH
HOOOHHOHOHHOHHOHOOHHOHOHHOHHOHOOOOOOOOOOOHHOHHHHOOOOHOOOOOGH
HHHHHHHHHHHHHHHHHHHHHHHHHHHHHHHHHHHHHHHHHHHHHHHHHHHHHHHHHHHH
